________________________________________________________________________________________________________________________________________________________________________________________________________
__________***_*_*_***_***_______________________________________________________________________________________________________________________________________________________________________________
__________*_*_*_*_*____*________________________________________________________________________________________________________________________________________________________________________________
__________***_*_*_**___*________________________________________________________________________________________________________________________________________________________________________________
__________*_*_*_*_*____*_______________________________________________________________________________________________________________________________________o________________________________________
__________***_***_***__*____________________oo______________oo_______________________________________________________x_______________________o__o_________o______________o______________________________
__________________________________________________________________________________________________________________******___________________****x________***______x______________**______________________
________________________________________________________________________________________________________________***_____________________***____***_o___________****_____________**______________________
_______________________________________________________*****xx******______________________________________oo__________________________***________***_________________________F__**______________________
____________________________________________________________**_____________________________________________________________________________________________________________*******______________________
_______________________oo________________********___________________________________________________________________________o___________________________________________________________________________
_________________oo_________oo___________________________________oo______________________________________***__________________________________________***_________**____________________________________
_________________**_________**___________________________________*****___________________________________***____________________________________________________________________________________________
_________________**____xx___**______________________________________________________________**__x***_____***______ooo_________o_________________________________________**______________________________
*************************************___________________________________________________**x***__**________________________________________________________ooo___________________________________________
____________________________________________________________ooo_x______________****x**__***_____________________________________________xxx________******______x________________________________________
____________________________________________________________*************__________*_________________________________________***_____************____________******__***______************************__