________________________________________________________________________________________________________________________________________________________________________________________________________
________________________________________________________________________________________________________________________________________________________________________________________________________
________________________________________________________________________________________________________________________________________________________________________________________________________
________________________________________________________________________________________________________________________________________________________________________________________________________
________________________________________________________________________________________________________________________________________________________________________________________________________
________________________________________________________________________________________________________________________________________________________________________________________________________
________________________________________________________________________________________________________________________________________________________________________________________________________
________________________________________________________________________________________________________________________________________________________________________________________________________
________________________________________________________________________________________________________________________________________________________________________________________________________
o_o_o_____________________o_o_____________________o_o_o_____________________o_o_____________________o_o_o_____________________o_o_____________________o_o_o_____________________o_o_____________________
________________________________________________________________________________________________________________________________________________________________________________________________________
*****____________________*****____________________*****____________________*****____________________*****____________________*****____________________*****____________________*****____________________
________________________________________________________________________________________________________________________________________________________________________________________________________
o________________o________________o________________o________________o________________o________________o________________o________________o________________o________________o________________o____________
________________________________________________________________________________________________________________________________________________________________________________________________________
________________________________________________________________________________________________________________F_______________________________________________________________________________________
********************************************************************************************************************************************************************************************************