________________________________________________________________________________________________________________________________________________________________________________________________________
________________________________________________________________________________________________________________________________________________________________________________________________________
________________________________________________________________________________________________________________________________________________________________________________________________________
________________________________________________________________________________________________________________________________________________________________________________________________________
________________________________________________________________________________________________________________________________________________________________________________________________________
________________________________________________________________________________________________________________________________________________________________________________________________________
________________________________________________________________________________________________________________________________________________________________________________________________________
_________________________________________________________________________________o_o_____________________o_o_o_____________________o_o_____________________o_o_o_____________________o_o________________
_______________________________________________________o_o_o___________________________________________________________________________________________________________________________________________
__________________oo______ooo__________________________*****____________________*****____________________*****____________________*****____________________*****_______________________________________
_________________________*****_________________________________________________________________________________________________________________________________________________________________________
_____________________oo______________________***________________________________________________________________________________________________________________________________________________________
_________ooooooooo________oooooooo_____________o________*****__________o________________o________________o________________o________________o________________o________________o________________o_________
_____________________________________*******_____________________________________________________________________________xx________________________________________________________F___________________
********************************************************************************************************************************************************************************************************
********************************************************************************************************************************************************************************************************
********************************************************************************************************************************************************************************************************