*******************************************************************
__________________________________________________________________*
__________________________________________________________________*
__________________________________________________________________*
__________________________________________________________________*
__________________________________________________________________*
__________________________________________________________________*
__________________________________________________________________*
__________________________________________________________________*
__________________________________*****___________________________*
________________________________***_______________________________*
_________*_____________*_oo____****oooo__*________________________*
______*******__________*_oo____****oooo__*________________________*
*******************************************************************
*******************************************************************
*******************************************************************
*******************************************************************