________________________________________________________________________________________________________________________________________________________________________________________________________
________________________________________________________________________________________________________________________________________________________________________________________________________
________________________________________________________________________________________________________________________________________________________________________________________________________
________________________________________________________________________________________________________________________________________________________________________________________________________
________________________________________________________________________________________________________________________________________________________________________________________________________
________________________________________________________________________________________________________________________________________________________________________________________________________
________________________________________________________________________________________________________________________________________________________________________________________________________
________________________________________________________________________________________________________________________________________________________________________________________________________
___________________________________________________________________________________________o_________________o________________________________________________________________________________________________
____________________o__________________________________o__________________________________o_o_______________o_o_______________________________________________________________________________________________
*__________________o_o________________________________o_o__________________*****_________*****_____________*****______________________________________________________________________________________________
**________________*****______________________________*****_________________*___**____________________________________________________________________________________________________________________
***______________*________________________________**___________________o___*o___________o________________o________________o________________o________________o________________o________________o_________
****____________*_____________________________**______________________**___*oo__________________________________________________________________________________________________________________________
*****__________*___________________________________________________________*ooo_______________________________________________________________________________________________________________________
********************************************************************************************************************************************************************************************************
********************************************************************************************************************************************************************************************************