________________________________________________________________________________________________________________________________________________________________________________________________________
_____***_*_*_***_***____________________________________________________________________________________________________________________________________________________________________________________
_____*_*_*_*_*____*_____________________________________________________________________________________________________________________________________________________________________________________
_____***_*_*_**___*_____________________________________________________________________________________________________________________________________________________________________________________
_____*_*_*_*_*____*_____________________________________________________________________________________________________________________________________________________________________________________
_____***_***_***__*_____________________________________________________________________________________________________________________________________________________________________________________
___________________________________________________________________________________________________________________oo____________________________________________F______________________________________
_______________________________________________________________________________________________________xooo_______*****_________________________________________x*______________________________________
________________________________________________________oo___________________________________________********___________________________________________________**______________________________________
_______________________________________________________*******______________________________oo_________________________________________________________________***______________________________________
______________________________________________oo___________________________________________****_______________________________________________________________****______________________________________
_____________________________________________****_____________******__________________________________________________________________________________________****______________________________________
____________________***__________________________________________________________________________________________________**___________________________________****______________________________________
_________________******_____________****__________________________________******__________________***_____________x______*****_oo__________________________*__****______________________________________
_______________********_______ooo_________x____oo___xx_______________ooo___________xx_oo_______******___________oo*****__*********xx____________o_________**__****______________________________________
***********************_____********____**********************______*****______**********************_________*****______****************______***______****__****______________________________________
***********************_____********____**********************______*****______**********************____________________****************______***______****__****______________________________________