_____________________________________________________________________________________________________________________________________________________________________________________________________________________________________________________________________________________________
________________________________________________________________________________________________________________________________________________________________________________________________________
________________________________________________________________________________________________________________________________________________________________________________________________________
________________________________________________________________________________________________________________________________________________________________________________________________________
________________________________________________________________________________________________________________________________________________________________________________________________________
________________________________________________________________________________________________________________________________________________________________________________________________________
________________________________________________________________________________________________________________________________________________________________________________________________________
___________________________o_o_____________________o_o_o_____________________o_o_____________________o_o_o_____________________o_o_____________________o_o_o_____________________o_o____________________
________________________________________________________________________________________________________________________________________________________________________________________________________
__________________oo_____*****____________________*****____________________*****____________________*****____________________*****____________________*****____________________*****____________________
________________________________________________________________________________________________________________________________________________________________________________________________________
_____________________oo______________________***________________________________________________________________________________________________________________________________________________________
_________________ooo______________o________*****__________o________________o________________o________________o________________o________________o________________o________________o______________________
_________________xx_____________________*******_____________xx__________xx______________xx__________________xx________________________xx________________________________________________________F_______
********************************************************************************************************************************************************************************************************
********************************************************************************************************************************************************************************************************
********************************************************************************************************************************************************************************************************