________________________________________________________________________________________________________________________________________________________________________________________________________
_____***_*_*_***_***____________________________________________________________________________________________________________________________________________________________________________________
_____*_*_*_*_*____*_____________________________________________________________________________________________________________________________________________________________________________________
_____***_*_*_**___*_____________________________________________________________________________________________________________________________________________________________________________________
_____*_*_*_*_*____*_____________________________________________________________________________________________________________________________________________________________________________________
_____***_***_***__*_____________________________________________________________________________________________________________________________________________________________________________________
______________________________________________________________________________________________________________________oo____________________________________________F___________________________________
__________________________________________________________________________________________________________xooo_______*****_________________________________________x*___________________________________
________________________________________________________oo______________________________________________********___________________________________________________**___________________________________
_______________________________________________________*******_________________________________oo_________________________________________________________________***___________________________________
______________________________________________oo______________________________________________****_______________________________________________________________****___________________________________
_____________________________________________****_____________*********__________________________________________________________________________________________****___________________________________
____________________***_____________________________________________________________________________________________________**___________________________________****___________________________________
_________________******_____________****_____________________________________******__________________***_____________x______*****_oo__________________________*__****___________________________________
_______________********_______ooo_________x____oo___xx__________________ooo___________xx_oo_______******___________oo*****__*********xx____________o_________**__****___________________________________
***********************_____********____**********************_________*****______**********************___________***______****************______***______****__****___________________________________
***********************_____********____**********************_________*****______**********************____________________****************______***______****__****___________________________________