________________________________________________________________________________________________________________________________________________________________________________________________________
__________***_*_*_***_***_______________________________________________________________________________________________________________________________________________________________________________
__________*_*_*_*_*____*________________________________________________________________________________________________________________________________________________________________________________
__________***_*_*_**___*________________________________________________________________________________________________________________________________________________________________________________
__________*_*_*_*_*____*________________________________________________________________________________________________________________________________________________________________________________
__________***_***_***__*________________________________________________________________________________________________________________________________________________________________________________
________________________________________________________________________________________________________________________________________________________________________________________________________
________________________________________________________________________________________________________________________________________________________________________________________________________
___________________________________________________________________________________________o_________________o__________________________________________________________________________________________
____________________o__________________________________o_____________________x____________o_o_______________o_o_________________________________________________________________________________________
___________________o_o________________________________o_o__________________*****_________*****_____________*****________________________________________________________________________________________
__________________*****______________________________*****_________________*___**_______________________________________________________________________________________________________________________
*________________*________________________________**___________________o___*o________**____o__________**__________________________________o________________o________________o___________________________
**______________*_____________________________**______________________**___*oo____________o_o________*__________________________________________________________________________________________________
***____________*___________ooo__xx__ooo____________________________________*ooo___________xxx_______*_______________________________________________________________________________________F___________
********************************************************************************************************************************************************************************************************
********************************************************************************************************************************************************************************************************