________________________________________________________________________________________________________________________________________________________________________________________________________
_____***_*_*_***_***____________________________________________________________________________________________________________________________________________________________________________________
_____*_*_*_*_*____*_____________________________________________________________________________________________________________________________________________________________________________________
_____***_*_*_**___*_____________________________________________________________________________________________________________________________________________________________________________________
_____*_*_*_*_*____*_____________________________________________________________________________________________________________________________________________________________________________________
_____***_***_***__*_____________________________________________________________________________________________________________________________________________________________________________________
___________________________________________________________________________________________________________________oo____________________________________________F______________________________________
_________________________________________________________ooo______________________________________________________*****_________________________________________x*______________________________________
_______________________________________________________*******________________________________________oox__o____________________________________________________**______________________________________
____________________________________________________________________________________________oo_______********__________________________________________________***______________________________________
______________________________________________oo___________________________________________****________________________________________________________________***______________________________________
_____________________________________________****______________oo_____________________________________________________________________________________________****______________________________________
____________________***_______________________________________****_______________________________________________________**___________________________________****______________________________________
_________________******_____________****__________________________________***_____________________***_____________x______*****_oo__________________________*__****______________________________________
_______________********_______ooo_________x____oo___xx_______________ooo___________xx_oo_______******___________oo*****__*********xx____________o_________**__****______________________________________
***********************_____********____**********************______*****______**********************_________*****______****************______***_____*****__****______________________________________
***********************_____********____**********************______*****______**********************____________________****************______***_____*****__******************************************