___________________________________________________________________________________________________
___________________________________________________________________________________________________
___________________________________________________________________________________________________
___________________________________________________________________________________________________
_____________________________*__________________________*__________________________________________
_______________________o_____**___o__________o__________**_________________________________________
_______________________**____**_______________*__________*___________o_____________________________
_______________________**____**_______________*__________*__________***____________________________
_______________________**____**_______________*__________*_________________________________________
_______________________**____**_____*_*_*_____*__________*_________________________________________
_______________________**____**_____*_______________________________________*______________________
_______________________**____**_____*______________________o______________**_______________________
_______________________**____**_____*____________________________________**________________________
_______________________**____**_____*___o_______________________________**_________________________
___________________________________________________________________________________________________
************************************************************_______________________________________
***************************************************************************************************