________________________________________________________________________________________________________________________________________________________________________________________________________
________________________________________________________________________________________________________________________________________________________________________________________________________
________________________________________________________________________________________________________________________________________________________________________________________________________
________________________________________________________________________________________________________________________________________________________________________****____________________________
_______________________________________________________________________________________________________________________________________________________________ooooo______**____________________________
__________________________________________________________________________________________________________________________________________________*******************______**___________________________
______________________________________________________________________________________________________________________________________________________________**_o__*______**___________________________
______________________________________________________________________________________________________________________________________________________________**_o______________________________________
__________________________________________________________________________ooooooo______________________________________________________*******________________**_o______________________________________
____________________________ooo___________________________________________*******____________________********___________________________________________x___oo**_o______________________________________
______________________________________________________ooo____________________________________******_________***_____________________________________***********************************_________________
_________________________********_____________________o_o________________________________*_____________________*_________________________________*_______________________________________*______________
_______________________***______________________*_____________*______________________*________________________***______________o___________o______*_____________________________________________________
_______________*****_______________ooo________***____xxxxx____***________________*_________________________xxx***______________*_____x_____*______*xxx__ooo*__xxxxxxxxxxxxxxxxxxxxxxxxx_____F___________
*************************_______oooo********************************************************************************************************************************************************************
*************************______oo***********************************************************************************************************************************************************************
*************************______*************************************************************************************************************************************************************************