*******************************************************************
__________________________________________________________________*
__________________________________________________________________*
__________________________________________________________________*
__________________________________________________________________*
__________________________________________________________________*
__________________________________________________________________*
__________________________________________________________________*
__________________________________________________________________*
__________________________________________________________________*
__________________________________________________________________*
__________________________________________________________________*
__________ooo_____________________________________________________*
*******************************************************************
*******************************************************************
*******************************************************************
*******************************************************************