________________________________________________________________________________________________________________________________________________________________________________________________________
________________________________________________________________________________________________________________________________________________________________________________________________________
________________________________________________________________________________________________________________________________________________________________________________________________________
________________________________________________________________________________________________________________________________________________________________________________________________________
________________________________________________________________________________________________________________________________________________________________________________________________________
________________________________________________________________________________________________________________________________________________________________________________________________________
________________________________________________________________________________________________________________________________________________________________________________________________________
________________________________________________________________________________________________________________________________________________________________________________________________________
___________________________________________________________________________________________o_________________o__________________________________________________________________________________________
____________________o__________________________________o__________________________________o_o_______________o_o_________________________________________________________________________________________
___________________o_o________________________________o_o__________________*****_________*****_____________*****________________________________________________________________________________________
__________________*****______________________________*****_________________*___**_______________________________________________________________________________________________________________________
*________________*________________________________**___________________o___*o________**________________**__________________o________________o________________o________________o________________o_________
**______________*_____________________________**______________________**___*oo________________________*_________________________________________________________________________________________________
***____________*___________ooo__xx__ooo____________________________________*ooo______________________*__________________________________________________________________________________________________
********************************************************************************************************************************************************************************************************
********************************************************************************************************************************************************************************************************