________________________________________________________________________________________________________________________________________________________________________________________________________
_____***_*_*_***_***____________________________________________________________________________________________________________________________________________________________________________________
_____*_*_*_*_*____*_____________________________________________________________________________________________________________________________________________________________________________________
_____***_*_*_**___*_____________________________________________________________________________________________________________________________________________________________________________________
_____*_*_*_*_*____*_____________________________________________________________________________________________________________________________________________________________________________________
_____***_***_***__*_____________________________________________________________________________________________________________________________________________________________________________________
________________________________________________________________________________________________________________________________________________________________________________________________________
_________________________________________________________________________________o_o_____________________o_o_o_____________________o_o_____________________o_o_o________________________________________
_______________________________________________________o_o_o____________________________________________________________________________________________________________________________________________
__________________oo______ooo__________________________*****____________________*****____________________*****____________________*****____________________*****________________________________________
_________________________*****__________________________________________________________________________________________________________________________________________________________________________
_____________________oo______________________***________________________________________________________________________________________________________________________________________________________
_________ooooooooo________oooooooo_____________o________*****__________o________________o________________o________________o________________o________________o________________o__________________________
_____________________________________*******_____________________________________________________________________________xx________________________________________________________F____________________
********************************************************************************************************************************************************************************************************
********************************************************************************************************************************************************************************************************
********************************************************************************************************************************************************************************************************