________________________________________________________________________________________________________________________________________________________________________________________________________
__________***_*_*_***_***_______________________________________________________________________________________________________________________________________________________________________________
__________*_*_*_*_*____*________________________________________________________________________________________________________________________________________________________________________________
__________***_*_*_**___*________________________________________________________________________________________________________________________________________________________________________________
__________*_*_*_*_*____*________________________________________________________________________________________________________________________________________________________________________________
__________***_***_***__*________________________________________________________________________________________________________________________________________________________________________________
__________________________________________________________________________________________________________________******_________________________********__________**_______**__________________________
________________________________________________________________________________________________________________***________________________________________________**_______**__________________________
________________________________________________________******xx******_____________________________________________________________________________________________**____F__**__________________________
______________________________________________________________**___________________________________________________________________________________________________***********__________________________
_________________________________________********_______________________________________________________________________________________******__________________________________________________________
___________________________________________________________________________________________________________***__________________________________________________________________________________________
__________________________________________________________________*****____________________________________***__________________________________________________________________________________________
_____________________________________________________________________________________________********______***__________________________________________________________________________________________
*************************************__________________________________________________********___________________________________________________*******_______________________________________________
________________________________________________________________x______________*********_________________________________________________*******________________________________________________________
____________________________________________________________*************____________________________________________________***_________******_________________________________________________________