****************************************************************************************************
__________________________________________________________________________________________________**
__________________________________________________________________________________________________**
__________________________________________________________________________________________________**
__________________________________________________________________________________________________**
__________________________________________________________________________________________________**
__________________________________________________________________________________________________**
__________________________________________________________________________________________________**
__________________________________________________________________________________________________**
__________________________________*****___________________________________________________________**
________________________________***_______________________________________________________________**
_________*_____________*_oo____****oooo__*________________________________________________________**
______*******__________*_oo____****oooo__*________________________________________________________**
****************************************************************************************************
****************************************************************************************************
****************************************************************************************************
****************************************************************************************************