________________________________________________________________________________________________________________________________________________________________________________________________________
__________***_*_*_***_***_______________________________________________________________________________________________________________________________________________________________________________
__________*_*_*_*_*____*________________________________________________________________________________________________________________________________________________________________________________
__________***_*_*_**___*________________________________________________________________________________________________________________________________________________________________________________
__________*_*_*_*_*____*_______________________________________________________________________________________________________________________________________o________________________________________
__________***_***_***__*____________________oo______________oo_______________________________________________________x_______________________o__o_________o______________o______________________________
__________________________________________________________________________________________________________________******___________________****x________***______x_______**_____**______________________
________________________________________________________________________________________________________________***_____________________***____***_o___________****______**_____**______________________
_______________________________________________________*****xx******______________________________________oo__________________________***________***_____________________**__F__**______________________
____________________________________________________________**___________________________________________________________________________________________________________**__*****______________________
_________________________________________********___________________________________________________________________________o___________________________________________________________________________
_________________oo_________oo___________________________________oo______________________________________***____________________________________________________________________________________________
_________________**____oo___**___________________________________*****___________________________________***____________________________________________***_____________________________________________
_________________**____xx___**______________________________________________________________**__x***_____***______ooo_________o_________________________________________________________________________
*************************************___________________________________________________**x***__**________________________________________________________ooo___________________________________________
____________________________________________________________ooo_x______________****x**__***_____________________________________________xxx________******______x________________________________________
____________________________________________________________*************__________*_________________________________________***_____************_____________****___***______************************__