________________________________________________________________________________________________________________________________________________________________________________________________________
_____***_*_*_***_***____________________________________________________________________________________________________________________________________________________________________________________
_____*_*_*_*_*____*_____________________________________________________________________________________________________________________________________________________________________________________
_____***_*_*_**___*_____________________________________________________________________________________________________________________________________________________________________________________
_____*_*_*_*_*____*_____________________________________________________________________________________________________________________________________________________________________________________
_____***_***_***__*_____________________________________________________________________________________________________________________________________________________________________________________
________________________________________________________________________________________________________________________________________________________________________________________________________
_______________________________________________________________________________________________________________________________________________________________________****_____________________________
______________________________________________________________________________________________________________________________________________________________**_o______________________________________
__________________________________________________________________________ooooooo_____________________oo__x___________________________________________________**_o______________________________________
____________________________ooo___________________________________________*******______________ooo___********___________________________________________x___oo**_o________________oo___oo_______________
______________________________________________________ooo____________________________________******_________***_____________________________________********************________________________________
_________________________********_____________________o_o__________***___________________*_____________________*_________________________________**_____________________***_____________________________
_______________________***______________________*_____________*______________________*________________________***______________o__________o______*________________________***___o____o____o_____________
_______________*****_______________ooo________***____xxxx_____***________________*_________________________xxx***______________*____x_____*______*xxx__ooo*__xxxxxxxxxxxxxxxx*****xx***xx***F___________
*************************_______oooo********************************************************************************************************************************************************************
*************************______oo***********************************************************************************************************************************************************************
*************************______*************************************************************************************************************************************************************************