________________________________________________________________________________________________________________________________________________________________________________________________________
_____***_*_*_***_***____________________________________________________________________________________________________________________________________________________________________________________
_____*_*_*_*_*____*_____________________________________________________________________________________________________________________________________________________________________________________
_____***_*_*_**___*_____________________________________________________________________________________________________________________________________________________________________________________
_____*_*_*_*_*____*_____________________________________________________________________________________________________________________________________________________________________________________
_____***_***_***__*_____________________________________________________________________________________________________________________________________________________________________________________
________________________________________________________________________________________________________________________________________________________________________________________________________
______________________________________________________________________________________________________________________________________________________________**_o______________________________________
__________________________________________________________________________ooooooo_____________________oo__x___________________________________________________**_o______________________________________
____________________________ooo___________________________________________*******______________ooo___********___________________________________________x___oo**_o______________oo___oo_________________
______________________________________________________ooo____________________________________******_________***_____________________________________********************________________________________
_________________________********_____________________o_o__________***___________________***________________***______________________________***______________________****______________________________
_______________________***_____________________**_____________**_____________________***____________________***______________o__________o_______________________________***__o___o____o_________________
_______________*****_______________ooo_______****____xxxx_____****______________***______________________xxx***_____________***____x___***______xxxxxxxxxxxxxxxxxxxxxxxxxx****xx***xx***F_______________
*************************_______oooo********************************************************************************************************************************************************************
*************************______oo***********************************************************************************************************************************************************************
*************************______*************************************************************************************************************************************************************************