________________________________________________________________________________________________________________________________________________________________________________________________________
_____***_*_*_***_***____________________________________________________________________________________________________________________________________________________________________________________
_____*_*_*_*_*____*_____________________________________________________________________________________________________________________________________________________________________________________
_____***_*_*_**___*_____________________________________________________________________________________________________________________________________________________________________________________
_____*_*_*_*_*____*_____________________________________________________________________________________________________________________________________________________________________________________
_____***_***_***__*_____________________________________________________________________________________________________________________________________________________________________________________
___________________________________________________________________________________________________________________oo____________________________________________F******________________________________
_________________________________________________________ooo______________________________________________________*****_________________________________________x*******________________________________
_______________________________________________________*******________________________________________oox__o____________________________________________________********________________________________
__________________________________________________________________________________________oo_________********__________________________________________________*********________________________________
______________________________________________oo_________________________________________****__________________________________________________________________*********________________________________
_____________________________________________****______________oo_____________________________________________________________________________________________**********________________________________
____________________***_______________________________________****_______________________________________________________**___________________________________**********________________________________
_________________******_____________****__________________________________***_____________________***_____________x______*****_oo__________________________*__**********________________________________
_______________********_______ooo_________x____oo___xx_______________ooo___________xx_oo_______******___________oo*****__*********xx____________o_________**__**********________________________________
***********************_____********____**********************______*****______**********************_________*****______****************______***_____*****__**********________________________________
***********************_____********____**********************______*****______**********************____________________****************______***_____*****__******************************************